000000000000011000000000000000
000000000000011000000000000000
000000000000011000000000000000
000000000000011000000000000000
000000000000011000000000000000
000000000000011000000000000000
000000000000111100000000000000
000000000011111111000000000000
000000000011111111000000000000
111111111111111111111111111111
111111111111111111111111111111
000000000011111111000000000000
000000000011111111000000000000
000000000000111100000000000000
000000000000011000000000000000
000000000000011000000000000000
000000000000011000000000000000
000000000000011000000000000000
000000000000011000000000000000
000000000000011000000000000000
000000000000011000000000000000
000000000000011000000000001100
000000000000011000000000001100
001110000000011000000000001100
001010000000011000000000001100
001110000000011111111111111100
111111111111111111111111111100
111111111111111000000000000000
000000000000011000000000000000
