000000000000000000000000000000
000000000000000000000000000000
000000000000000000000000000000
000000000000000000000000000000
000001111111111111111111110000
000001111111111111111111110000
000001111111111111111111110000
000001111111111111111111110000
000000000000111111100000000000
000000000000111111100000000000
000000000000111111100000000000
000000000000111111100000000000
000000000000111111100000000000
000000000000111111100000000000
000000000000111111100000000000
000000000000111111100000000000
000000000000111111100000000000
000000000000000100000000000000
000000000000000000000000000000