000000000000000000000000000000
000000000000000000000000000000
000000000000000000000000000000
000000000000000000000000000000
000000000000000000000000000000
000000000000000000000000000000
000000111111111111111111000000
000000111111111111111111000000
000000111111111111111111000000
000000111111111111111111000000
000000000000111111000000000000
000000000000111111000000000000
000000000000111111000000000000
000000000000111111000000000000
000000000000111111000000000000
000000000000111111000000000000
000000000000111111000000000000
000000000000111111000000000000
000000000000000000000000000000
000000000000000000000000000000
