000000000000000
000000000000000
000000000000000
000111111111000
000111111111000
000000111000000
000000111000000
000000111000000
000000111000000
000000000000000
