000000000000000000000000000000
000000000000000000000000000000
000111111111111111111111111100
000111111111111111111111111100
000111111111111111111111111100
000111111111111111111111111100
000000000011111111111000000000
000000000011111111111000000000
000000000011111111111000000000
000000000011111111111000000000
000000000011111111111000000000
000000000011111111111000000000
000000000011111111111000000000
000000000011111111111000000000
000000000011111111111000000000
000000000011111111111000000000
000000000011111111111000000000
000000000000000100000000000000
000000000000000000000000000000