000000000000000
000000000000000
000000000000000
011110000011110
011110000011110
011110000011110
011111111111110
011111111111110
000000010000000
000000000000000
