0000000000000000000000000000000000
0000000000000000000000000000000000
0000000000000000000000000000000000
0000000000000000000000000000000000
0000000000000000000000000000000000
0000000000000000000000000000000000
0011111111100000000000111111111000
0011111111100000000000111111111000
0011111111100000000000111111111000
0011111111100001110000111111111000
0011111111100001110000111111111000
0011111111111111111111111111111000
0011111111111111111111111111111000
0011111111111111111111111111111000
0011111111111111111111111111111000
0011111111111111111111111111111000
0011111111111111111111111111111000
0000000000000000100000000000000000
0000000000000000000000000000000000
0000000000000000000000000000000000
