00000000000000000
00000000000000000
01111100000111110
01111100000111110
01111100100111110
01111111111111110
01111111111111110
01111111111111110
00000000100000000
00000000000000000
