0000000000000000000000000000000000
0000000000000000000000000000000000
0000000000000000000000000000000000
0000000000000000000000000000000000
0000000000000000000000000000000000
0000000000000000000000000000000000
0111111111000000000001111111110000
0111111111000000000001111111110000
0111111111000000000001111111110000
0111111111000001100001111111110000
0111111111000001100001111111110000
0111111111111111111111111111110000
0111111111111111111111111111110000
0111111111111111111111111111110000
0111111111111111111111111111110000
0111111111111111111111111111110000
0111111111111111111111111111110000
0000000000000000100000000000000000
0000000000000000000000000000000000
0000000000000000000000000000000000
