00000000000000000000000000000000
00000000000000110000000000000000
00000000000000111000000000000000
00000000000000110000000000000000
00000000000001110000000000000000
00000000000000111000000000000000
00000000000000110000000000000000
00000000000001111000000000000100
00000000000111111110000000000100
00010000100111111110010000010100
01111111111111111111111111111110
01111111111111111111111111111110
00000000000111111110000000000000
00000000000111111110000000000000
00000000000001110000000000000000
00000000000000110000000000000000
00000000000000110000000000000000
00000000000000110000000000000000
00000000000000111000000000000000
00000000000001110000000000000000
00000000000000110000000000000000
00000000000000111000000000001000
00001000000001110000000000011000
00001000000000110000000000011000
00011100000000111000000000011000
00010100000001110000000100011000
00011100000000111111111111111100
01111111111111111111111111111000
01111111111111110010001000100000
00000000000000110000000000000000
00000000000000000000000000000000
