0000000000000000000000000000000000000000000000000000000000000000
0000000000000000000000000000000000000000000000000000000000000000
0000000000000000000000000000111100000000000000000000000000000000
0000000000000000000000000000111111000000000000000000000000000000
0000000000000000000000000000111111000000000000000000000000000000
0000000000000000000000000000111100000000000000000000000000000000
0000000000000000000000000000111100000000000000000000000000000000
0000000000000000000000000000111100000000000000000000000000000000
0000000000000000000000000000111100000000000000000000000000000000
0000000000000000000000000011111100000000000000000000000000000000
0000000000000000000000000011111100000000000000000000000000000000
0000000000000000000000000000111111000000000000000000000000000000
0000000000000000000000000000111111000000000000000000000000000000
0000000000000000000000000000111100000000000000000000000000000000
0000000000000000000000000011111111000000000000000000000000000000
0000000000000000000000000011111111000000000000000000000001100000
0000000000000000000000001111111111111100000000000000000001100000
0000000000000000000000001111111111111100000000000000000001100000
0000000000000000000000111111111111111100011000000000000001100000
0000001100000000110000111111111111111100011000000000011001100000
0000001100000000110000111111111111111100011000000000011001100000
0011111111111111111111111111111111111111111111111111111111111100
0011111111111111111111111111111111111111111111111111111111111100
0011111111111111111111111111111111111111111111111111111111111100
0011111111111111111111111111111111111111111111111111111111111100
0000000000000000000000111111111111111100000000000000000000000000
0000000000000000000000111111111111111100000000000000000000000000
0000000000000000000000111111111111111100000000000000000000000000
0000000000000000000000111111111111111100000000000000000000000000
0000000000000000000000001111111100000000000000000000000000000000
0000000000000000000000000011111100000000000000000000000000000000
0000000000000000000000000000111000000000000000000000000000000000
0000000000000000000000000000111000000000000000000000000000000000
0000000000000000000000000000111000000000000000000000000000000000
0000000000000000000000000000111000000000000000000000000000000000
0000000000000000000000000000111000000000000000000000000000000000
0000000000000000000000000000111110000000000000000000000000000000
0000000000000000000000000000111110000000000000000000000000000000
0000000000000000000000000011111110000000000000000000000000000000
0000000000000000000000000011111000000000000000000000000000000000
0000000000000000000000000011111000000000000000000000000000000000
0000000000000000000000000000111000000000000000000000000000000000
0000000000000000000000000000111110000000000000000000000110000000
0000000000000000000000000000111110000000000000000000000110000000
0000000000000000000000000011111110000000000000000000011110000000
0000000011000000000000000011111000000000000000000000011110000000
0000000011000000000000000011111000000000000000000000011110000000
0000000011000000000000000000111000000000000000000000011110000000
0000001111110000000000000000111110000000000000000000011110000000
0000001111110000000000000000111110000000000000000000011110000000
0000001100110000000000000011111110000000000000110000011110000000
0000001100110000000000000011111000000000000000110000011110000000
0000001111110000000000000000111111111111111111111111111111110000
0000001111110000000000000000111111111111111111111111111111110000
0011111111111111111111111111111111111111111111111111111110000000
0011111111111111111111111111111111111111111111111111111110000000
0011111111111111111111111111111100011000000110000001100000000000
0011111111111111111111111111111100011000000110000001100000000000
0000000000000000000000000000111100000000000000000000000000000000
0000000000000000000000000000111100000000000000000000000000000000
0000000000000000000000000000000000000000000000000000000000000000
0000000000000000000000000000000000000000000000000000000000000000