0000000000000000000000000000000000000000000000000000000000000000
0000000000000000000000000000010000000000000000000000000000000000
0000000000000000000000000000111000000000000000000000000000000000
0000000000000000000000000000111110000000000000000000000000000000
0000000000000000000000000000111110000000000000000000000000000000
0000000000000000000000000000111000000000000000000000000000000000
0000000000000000000000000000111000000000000000000000000000000000
0000000000000000000000000000111000000000000000000000000000000000
0000000000000000000000000000111000000000000000000000000000000000
0000000000000000000000000011111000000000000000000000000000000000
0000000000000000000000000011111000000000000000000000000000000000
0000000000000000000000000000111110000000000000000000000000000000
0000000000000000000000000000111110000000000000000000000000000000
0000000000000000000000000000111000000000000000000000000000000000
0000000000000000000000000000111000000000000000000000000000000000
0000000000000000000000000011111111000000000000000000000001100000
0000000000000000000000000011111111000000000000000000000001100000
0000000000000000000000001111111111111000000000000000000001100000
0000000000000000000000001111111111111000000000000000000001100000
0000001100000000110000111111111111111000011000000000011001100000
0000001100000000110000111111111111111000011000000000011001100000
0011111111111111111111111111111111111111111111111111111111111000
0011111111111111111111111111111111111111111111111111111111111000
0011111111111111111111111111111111111111111111111111111111111000
0011111111111111111111111111111111111111111111111111111111111000
0000000000000000000000111111111111111000000000000000000000000000
0000000000000000000000111111111111111000000000000000000000000000
0000000000000000000000111111111111111000000000000000000000000000
0000000000000000000000111111111111111000000000000000000000000000
0000000000000000000000001111111000000000000000000000000000000000
0000000000000000000000000011111000000000000000000000000000000000
0000000000000000000000000000111000000000000000000000000000000000
0000000000000000000000000000111000000000000000000000000000000000
0000000000000000000000000000111000000000000000000000000000000000
0000000000000000000000000000111000000000000000000000000000000000
0000000000000000000000000000111000000000000000000000000000000000
0000000000000000000000000000111110000000000000000000000000000000
0000000000000000000000000000111110000000000000000000000000000000
0000000000000000000000000011111110000000000000000000000000000000
0000000000000000000000000011111000000000000000000000000000000000
0000000000000000000000000011111000000000000000000000000000000000
0000000000000000000000000000111000000000000000000000000000000000
0000000000000000000000000000111110000000000000000000000110000000
0000000000000000000000000000111110000000000000000000000110000000
0000000000000000000000000011111110000000000000000000000110000000
0000000011000000000000000011111000000000000000000000011110000000
0000000011000000000000000011111000000000000000000000011110000000
0000000011000000000000000000111000000000000000000000011110000000
0000001111110000000000000000111110000000000000000000011110000000
0000001111110000000000000000111110000000000000000000011110000000
0000001100110000000000000011111110000000000001100000011110000000
0000001100110000000000000011111000000000000001100000011110000000
0000001111110000000000000000111111111111111111111111111111100000
0000001111110000000000000000111111111111111111111111111111100000
0011111111111111111111111111111111111111111111111111111110000000
0011111111111111111111111111111111111111111111111111111110000000
0011111111111111111111111111111000001000000110000001100000000000
0011111111111111111111111111111000001000000110000001100000000000
0000000000000000000000000000111000000000000000000000000000000000
0000000000000000000000000000111000000000000000000000000000000000
0000000000000000000000000000000000000000000000000000000000000000
0000000000000000000000000000000000000000000000000000000000000000