00000000000000000
01000100000001000
01111100000001000
01111100010001110
01111111111111110
00000111111111110
00000111110000000
00000001110000000
00000001110000000
00000001110000000
00000000000000000
