000000000000000000000
001111110111111111100
001111110111111111100
001111111111111111100
001111111111111111100
000000011111110000000
000000011101110000000
000000001101100000000
000000001101100000000
000000001111100000000
000000001111100000000
000000001111100000000
000000001111100000000
000001111111111100000
000001111111111100000
000111111111111111000
000111111111111111000
000111111111111111000
000111111111111111000
000111111111111111000
000000000010000000000
000000000000000000000